10 17
2 2
1 1 1 1 1 1 1 1 1 1 1 1 1 1 1 1 1 
1 3 3 1 3 3 3 3 3 1 3 3 3 3 3 3 1 
1 3 3 1 3 3 3 3 3 1 3 3 3 3 3 3 1 
1 3 3 1 3 3 1 3 3 1 3 3 1 3 3 3 1 
1 3 3 1 3 3 1 3 3 1 3 3 1 3 3 3 1 
1 3 3 1 3 3 1 3 3 1 3 3 1 3 3 3 1 
1 3 3 1 3 3 1 3 3 1 3 3 1 3 3 3 1 
1 3 3 3 3 3 1 3 3 3 3 3 1 3 3 3 1 
1 3 3 3 3 3 1 3 3 3 3 3 1 3 3 3 1 
1 1 1 1 1 1 1 1 1 1 1 1 1 1 1 1 1 
1 1 1 1 1 1 1 1 1 1 1 1 1 1 1 1 1 
1 1 1 1 1 1 1 1 1 1 1 1 1 1 1 1 1 
1 1 1 1 1 1 1 1 1 1 1 1 1 1 1 1 1 
1 1 1 1 1 1 1 1 1 1 1 1 1 1 1 1 1 
1 1 1 1 1 1 1 1 1 1 1 1 1 1 1 1 1 
1 1 1 1 1 1 1 1 1 1 1 1 1 1 1 1 1 
1 1 1 1 1 1 1 1 1 1 1 1 1 1 1 1 1 
1 1 1 1 1 1 1 1 1 1 1 1 1 1 1 1 1 
1 1 1 1 1 1 1 1 1 1 1 1 1 1 1 1 1 
1 1 1 1 1 1 1 1 1 1 1 1 1 1 1 1 1 3 3 3 3 3 3 3 3 3 3 3 3 3 3 3 3 3 
3 2 4 3 2 3 3 1 2 3 2 1 3 3 4 2 3 
3 5 3 3 1 3 3 3 3 3 5 3 3 3 3 1 3 
3 3 3 3 3 3 3 3 3 3 3 3 3 3 3 3 3 
3 3 3 3 3 3 3 3 3 3 3 3 3 3 3 3 3 
3 3 3 3 3 3 3 3 5 3 3 3 3 3 3 3 3 
3 3 3 3 3 3 3 3 3 3 3 3 3 3 3 3 3 
3 3 3 3 3 5 3 3 3 3 3 1 3 5 5 5 3 
3 2 1 3 3 4 3 2 1 4 3 2 3 4 1 2 3 
3 3 3 3 3 3 3 3 3 3 3 3 3 3 3 3 3 