10 17
5 3
3 3 3 3 3 3 3 3 3 3 3 3 3 3 3 3 3 
3 3 3 3 3 3 3 3 3 3 3 3 3 3 3 3 3 
3 3 3 3 1 1 1 1 1 1 1 1 3 3 3 3 3 
3 3 3 3 1 5 3 3 3 3 3 1 3 3 3 3 3 
3 3 3 3 1 3 3 3 3 3 3 1 3 3 3 3 3 
3 3 3 3 1 3 3 3 3 3 3 1 3 3 3 3 3 
3 3 3 3 1 3 3 3 3 3 3 1 3 3 3 3 3 
3 3 3 3 1 3 3 3 3 3 3 1 3 3 3 3 3 
3 3 3 3 1 1 1 1 1 1 1 1 3 3 3 3 3 
3 3 3 3 3 3 3 3 3 3 3 3 3 3 3 3 3 
2 3 2 3 2 3 2 3 2 3 2 3 2 3 2 3 2 
3 2 3 2 3 2 3 2 3 2 3 2 3 2 3 2 3 
2 3 2 3 1 1 1 1 1 1 1 1 2 3 2 3 2 
3 2 3 2 1 1 1 1 1 1 1 1 3 2 3 2 3 
2 3 2 3 1 1 1 1 1 1 1 1 2 3 2 3 2 
3 2 3 2 1 1 1 1 1 1 1 1 3 2 3 2 3 
2 3 2 3 1 1 1 1 1 1 1 1 2 3 2 3 2 
3 2 3 2 1 1 1 1 1 1 1 1 3 2 3 2 3 
2 3 2 3 1 1 1 1 1 1 1 1 2 3 2 3 2 
3 2 3 2 3 2 3 2 3 2 3 2 3 2 3 2 3 3 3 3 3 3 3 3 3 3 3 3 3 3 3 3 3 3 
3 3 3 3 3 3 3 3 3 3 3 3 3 3 3 3 3 
3 3 3 3 3 3 3 3 3 3 3 3 3 3 3 3 3 
3 3 3 3 3 3 3 3 11 3 3 3 3 3 3 3 3 
3 3 3 3 3 3 3 3 11 3 3 3 3 3 3 3 3 
3 3 3 3 3 3 3 3 11 3 3 3 3 3 3 3 3 
3 3 3 3 3 11 11 11 11 3 3 3 3 3 3 3 3 
3 3 3 3 3 3 3 3 3 3 3 3 3 3 3 3 3 
3 3 3 3 3 3 3 3 3 3 3 3 3 3 3 3 3 
3 3 3 3 3 3 3 3 3 3 3 3 3 3 3 3 3 