10 17
2 2
0 1 1 1 1 1 1 1 1 1 1 1 0 0 0 0 1 
0 1 0 0 0 0 0 1 0 0 0 0 0 1 0 0 1 
0 0 1 1 0 0 1 1 0 1 0 1 1 1 1 0 1 
0 0 0 0 1 0 0 1 1 0 0 0 1 1 0 0 1 
0 1 1 1 0 0 1 1 1 1 0 0 1 0 0 1 1 
0 0 0 1 0 1 0 0 0 0 1 0 1 1 0 0 1 
0 1 0 0 0 0 0 1 0 1 0 0 1 1 0 0 1 
0 0 1 1 1 1 0 1 0 1 1 0 1 0 1 0 1 
0 0 0 0 0 0 1 0 0 0 0 1 1 0 0 1 1 
1 1 1 1 1 1 1 1 1 1 1 1 1 1 1 1 1 
2 3 3 3 3 3 3 3 3 3 3 3 2 2 2 2 3 
2 3 2 2 2 2 2 3 2 2 2 2 2 3 2 2 3 
2 2 3 3 2 2 3 3 2 3 2 3 3 3 3 2 3 
2 2 2 2 3 2 2 3 3 2 2 2 3 3 2 2 3 
2 3 3 3 2 2 3 3 3 3 2 2 3 2 2 3 3 
2 2 2 3 2 3 2 2 2 2 3 2 3 3 2 2 3 
2 3 2 2 2 2 2 3 2 3 2 2 3 3 2 2 3 
2 2 3 3 3 3 2 3 2 3 3 2 3 2 3 2 3 
2 2 2 2 2 2 3 2 2 2 2 3 3 2 2 3 3 
3 3 3 3 3 3 3 3 3 3 3 3 3 3 3 3 3 3 3 3 3 3 3 3 3 3 3 3 3 3 3 3 3 3 
3 3 3 3 2 2 2 3 3 3 3 3 3 3 3 3 3 
3 3 3 3 3 3 3 3 3 3 3 3 3 3 3 3 3 
3 3 3 3 3 3 2 3 3 3 3 3 3 3 3 3 3 
3 3 3 3 3 3 3 3 3 3 3 3 3 3 3 3 3 
3 3 3 3 3 3 3 3 3 3 3 3 3 3 4 3 3 
3 3 3 3 3 3 3 3 3 3 3 3 3 3 4 4 3 
3 3 3 3 3 3 3 3 3 3 3 3 3 3 3 4 3 
3 3 3 3 3 3 3 3 3 3 3 3 3 3 4 3 3 
3 3 3 3 3 3 3 3 3 3 3 3 3 3 3 3 3 